.............................
..#######........#########...
..#.....#........#.......#...
..###.###................#...
.................#.......#...
.................#########...
..X..........................
...........###############...
...........#........#....#...
................#...###..#...
...........#....#........#...
...........###############...
.............................
...........X.................
.............................
...####..###########..####...
...#.....................#...
...#.....................#...
...#######################...
.............................